* *  **   
**  *** * 
*  *&&*   
  **&*   *
**  **  * 
*****&**  
*&&* *    
**&**#**  
&***&*&* *
* * **** *
