*  ***&*&*
    *&*&**
    *&**&*
* *  ** * 
***  *&** 
   * ***&*
 * **&&***
 * ***** *
   *    **
 *  ***   
