  ***   **
 **  *    
**** **  *
* *&*  * *
  *&**  * 
*  * * *  
* ***&*&* 
 *&&**&*  
* *&&&* * 
******  **
